13 12
13 155
m ~ ~ m m m X m m ~ ~ m .
m ~ ~ m m m X m m ~ ~ m m
m ~ ~ m m m X m m ~ ~ X X
m ~ ~ ~ ~ ~ ~ ~ ~ ~ X X X
~ ~ ~ ~ ~ ~ ~ ~ ~ ~ ~ m m
~ ~ ~ m m m X m m ~ ~ m m
m ~ ~ m m m X m m ~ ~ m X
m ~ ~ ~ ~ ~ ~ ~ ~ ~ ~ m X
m ~ ~ ~ ~ ~ ~ ~ ~ ~ ~ m m
m ~ ~ m m m m m m ~ ~ m m
. X X X X X X X X X X X X
X X X X X X X X X X X X X
